##########
#s#...####
#..###.###
#....##.##
#####.##.#
##...###.#
#.######.#
#....###.#
#.##....f#
##########